WWWWWWWWWWWWWWWWWWW
WOOOOOOOOOOOOOOOOOO
WOOOOXXXOOXXXXOOOOO
WOOCXXXXXXXXXXOOOOO
WOOOOXXXXXXXXXXXOOO
WOOOXXXXXOCXXXXOOOO
WOOOOXOOXOXXXXOOOOO
WOOOOOOOOOOOOOOOOOO
WWWWWWWWWWWWWWWWWWW