WWWWWWWWWWWWWWWWWWWWWWWXXX
OOOOOOOOOOOOOOOOOOOOOOOOXX
OOOOOOOOOOOOOOOOOOOOOOOOXX
OOOOOOOOOOOOOOOOOOOOOOOOXX
OOOOOOOOOOOOOOOOOOOOOOOOOO
OOOOOOOOOOOOOOOOOOOOOOOOOX
OOOOOOOWWOOOOOOOOOOOOOOOWX
OOOOOOWWWWWOOOOOOOOOOOOWWX
WWWWWWWWWWWWWWWWWWWWWWWWWX